{
	"width" : 22,
	"depth" : 20,

	"sunlight" : [-1, 1, 1],

	"altitude" : [
		3, 3, 2, 1, 0, 0, 0, 0, 0, 0, 0, 0, 0, 0, 0, 0, 0, 0, 0, 0, 0, 0,
		3, 3, 2, 1, 0, 0, 0, 0, 0, 0, 0, 0, 0, 0, 0, 0, 0, 0, 0, 0, 0, 0,
		3, 3, 4, 4, 4, 4, 4, 4, 4, 4, 4, 4, 4, 4, 4, 4, 4, 3, 2, 1, 0, 0,
		3, 3, 4, 5, 5, 5, 5, 5, 5, 5, 5, 5, 5, 5, 5, 5, 4, 3, 2, 1, 0, 0,
		3, 3, 4, 5, 6, 6, 6, 6, 6, 6, 6, 6, 6, 6, 6, 5, 4, 3, 2, 1, 0, 0,
		3, 3, 4, 5, 6, 7, 7, 7, 7, 7, 7, 7, 7, 7, 6, 5, 4, 3, 2, 1, 0, 0,
		3, 3, 4, 5, 6, 7, 8, 8, 8, 8, 8, 8, 8, 7, 6, 5, 4, 3, 2, 1, 0, 0,
		3, 3, 4, 5, 6, 7, 8, 8, 8, 8, 8, 8, 8, 7, 6, 5, 4, 3, 2, 1, 0, 0,
		3, 3, 4, 5, 6, 7, 8, 8, 9, 9, 9, 8, 8, 7, 6, 5, 4, 3, 2, 1, 0, 0,
		3, 3, 4, 5, 6, 7, 8, 8, 9, 9, 9, 8, 8, 7, 6, 5, 4, 3, 2, 1, 0, 0,
		3, 3, 4, 5, 6, 7, 8, 8, 9, 9, 9, 8, 8, 7, 6, 5, 4, 3, 2, 1, 0, 0,
		3, 3, 4, 5, 6, 7, 8, 8, 8, 8, 8, 8, 8, 7, 6, 5, 4, 3, 2, 1, 0, 0,
		3, 3, 4, 5, 6, 7, 8, 8, 8, 8, 8, 8, 8, 7, 6, 5, 4, 3, 2, 1, 0, 0,
		3, 3, 4, 5, 6, 7, 7, 7, 7, 7, 7, 7, 7, 7, 6, 5, 4, 3, 2, 1, 0, 0,
		3, 3, 4, 5, 6, 6, 6, 6, 6, 6, 6, 6, 6, 6, 6, 5, 4, 3, 2, 1, 0, 0,
		3, 3, 4, 5, 5, 5, 5, 5, 5, 5, 5, 5, 5, 5, 5, 5, 4, 3, 2, 1, 0, 0,
		3, 3, 4, 4, 4, 4, 4, 4, 4, 4, 4, 4, 4, 4, 4, 4, 4, 3, 2, 1, 0, 0,
		3, 3, 2, 1, 0, 0, 0, 0, 3, 3, 3, 3, 0, 0, 0, 0, 0, 0, 0, 0, 0, 0,
		3, 3, 2, 1, 0, 0, 0, 0, 0, 0, 0, 0, 0, 0, 0, 0, 0, 0, 0, 0, 0, 0,
		3, 3, 2, 1, 0, 0, 0, 0, 0, 0, 0, 0, 0, 0, 0, 0, 0, 0, 0, 0, 0, 0
	], 

	"trees" : [
		{
			"x" : 7,
			"z" : 7

		},
		{
			"x" : 10,
			"z" : 10
		}
	],

	"roads" : [
		{
			"width" : 2,
			"spine": [
				19, 9,
				18, 7,
				17, 5,
				16, 7,
				15, 9,
				14, 10,
				13, 10,
				12, 10,
				10, 10,
				7,  10
			]
		},
		{
			"width" : 1,
			"spine" : [
				9, 19,
				9, 18,
				8, 17,
				9, 14,
				7, 13,
				8, 12,
				9, 10
			]	
		}
	], 

	"creeps" : [
		{
			"no." : 1,
			"locations" : [
				8, 9
			] 

		}
	],

	"LTree" : [
		{
			"iter" : 3,
			"type" : 1,
			"location" : [
				12, 6
			]
		},
		{
			"iter" : 3,
			"type" : 3,
			"location" : [
				17, 12			
			]
		}

	]
}
